######
#@   #
#. $ #
#    #
######
