#######
#.@   #
# * $ #
#     #
# .. *#
#     #
#######