#######
#.@   #
#$* $ #
#   $ #
# ..  #
## *  #
#######