#####
#@ ##
#.$* #
#   ##
#    #
######