  ########
 ####    #
# @ .$  ##
#   $  ###
#  .  ##
#     #
#######