  #####
###   #   
# @ .$#
#   $ #
#  .  #
#     #
#######